{"0_Name":"TestMap","1_Size":[[21,13]],"Map":
[
    5,5,5,5,5,5,5,5,5,5,5,5,5,5,5,5,5,5,5,5,5,
    5,0,0,0,0,0,0,0,0,0,0,0,0,0,0,0,0,0,0,0,5,
    5,0,0,0,0,0,0,0,0,0,0,0,0,0,0,0,0,0,0,0,5,
    5,0,0,0,0,0,0,0,0,0,0,0,0,0,0,0,0,0,0,0,5,
    5,0,0,0,0,0,0,0,0,0,0,0,0,0,0,0,0,0,0,0,5,
    5,0,0,0,0,0,0,0,0,0,0,0,0,0,0,0,0,0,0,0,5,
    5,0,0,0,0,0,0,0,0,0,0,0,0,0,0,0,0,0,0,0,5,
    5,0,0,0,0,0,0,0,0,0,0,0,0,0,0,0,0,0,0,0,5,
    5,0,0,0,0,0,0,0,0,0,0,0,0,0,0,0,0,0,0,0,5,
    5,0,0,0,0,0,0,0,0,0,0,0,0,0,0,0,0,0,0,0,5,
    5,0,0,0,0,0,0,0,0,0,0,0,0,0,0,0,0,0,0,0,5,
    5,1,1,1,1,1,1,1,1,1,1,1,1,1,1,6,1,6,1,6,5,
    5,5,5,5,5,5,5,5,5,5,5,5,5,5,5,5,5,5,5,5,5],"2_RoomNum":[0]}