{"0_Name":"TestMap","1_Size":[[21,12]],"Map":
[
    2,2,2,2,2,2,2,2,2,2,2,2,2,2,2,2,2,2,2,2,2,
    2,0,0,0,0,0,0,0,0,0,0,0,0,0,0,0,0,0,0,0,2,
    2,0,0,0,0,0,0,0,0,0,0,0,0,0,0,0,0,0,0,0,2,
    2,0,0,0,0,0,0,0,0,0,0,0,0,0,0,0,0,0,0,0,2,
    2,0,0,0,0,0,0,0,0,0,0,0,0,0,0,0,0,0,0,0,2,
    2,0,0,0,0,0,0,0,0,0,0,0,0,0,0,0,0,0,0,0,2,
    2,0,0,0,0,0,0,0,0,0,0,0,0,0,0,0,0,0,0,0,2,
    2,0,0,0,0,0,0,0,0,0,0,0,0,0,0,0,0,0,0,0,2,
    2,0,0,0,0,0,0,0,0,0,0,0,0,0,0,0,0,0,0,0,2,
    2,0,0,0,0,0,0,0,0,0,0,0,0,0,0,0,0,0,0,0,2,
    2,0,0,0,0,0,0,0,0,0,0,0,0,0,0,0,0,0,0,0,2,
    2,1,1,1,1,1,1,1,1,1,1,1,1,1,1,1,1,1,1,1,2
],"2_RoomNum":[0]}